XXXOOOOOOOOOOOOOOOOOOOOOXX
XXXOOOOOOOOOOOOOOOOOOOOOXX
XXOOOOOOOOOOOOOOOOOOOOOOXX
OOOOOOOOOOOOOOOOOOOOOOOOOE
OOOOOOOOOOOOOOOOOOOOOOOOOE
GGGGGGGGGGGGGGGGGGGGGGGGGG
XXXXXXXXXXXXXXXXXXXXXXXXXX
XXXXXXXXXXXXXXXXXXXXXXXXXX